#########
#A      #
# ##    #
# #    ##
# ###   #
# ##    #
#      B#
#########